#############
#..#....R...#
#...##..∈...#
#.......Y...#
#...........#
#.@....###..#
#......#....#
#############